Project Version       Minecraft Version       Date Released

1.0.2                 1.16.5                  01/15/2021
1.0.3                 1.16.5                  03/14/2021
1.1.0                 1.17                    06/10/2021
1.1.1                 1.17                    06/10/2021
1.1.2                 1.17.1                  07/10/2021
1.1.3                 1.18                    11/30/2021
1.1.4                 1.18.1                  12/17/2021
